category,success,failed,backers,pledged,goal,maincategory,nprojects
3D Printing,242,441,158779,66323,46619,Technology,683
Academic,188,728,37751,2890,54531,Publishing,916
Accessories,1073,2092,256036,6526,14683,Fashion,3165
Action,107,633,34708,3699,317156,Film & Video,740
Animals,63,192,10748,2994,10586,Photography,255
Animation,682,1859,333433,9945,91451,Film & Video,2541
Anthologies,521,263,178366,9851,9359,Comics,784
Apparel,1414,5752,367844,5463,33368,Fashion,7166
Apps,378,5967,144290,1640,70703,Technology,6345
Architecture,179,581,39362,6404,414474,Design,760
Art,3385,4868,369311,3583,47390,Art,8253
Art Books,1356,1320,335466,8925,11153,Publishing,2676
Audio,111,299,22205,3527,16743,Journalism,410
Bacon,38,183,5075,1407,22538,Food,221
Blues,117,151,12231,3998,10519,Music,268
Calendars,128,201,28307,3872,6024,Publishing,329
Camera Equipment,192,224,179939,81362,39868,Technology,416
Candles,55,374,5038,563,5702,Crafts,429
Ceramics,132,173,14553,4705,12958,Art,305
Children's Books,2348,4408,410255,3547,11084,Publishing,6756
Childrenswear,95,388,19586,3484,16020,Fashion,483
Chiptune,27,8,15538,17691,6959,Music,35
Civic Design,104,185,34991,11470,153884,Design,289
Classical Music,1647,966,140545,4621,8516,Music,2613
Comedy,912,1408,188545,6093,77477,Film & Video,2320
Comic Books,1614,1129,238323,3413,5712,Comics,2743
Comics,2506,2490,643900,6536,32904,Comics,4996
Community Gardens,66,232,5561,1603,44837,Food,298
Conceptual Art,366,664,27651,1627,43058,Art,1030
Cookbooks,130,410,53637,5790,15019,Food,540
Country & Folk,2812,1639,294644,4807,21963,Music,4451
Couture,42,233,3321,1383,56831,Fashion,275
Crafts,1162,3502,146691,1736,9636,Crafts,4664
Crochet,35,127,1272,297,3693,Crafts,162
DIY,183,990,20581,1113,17837,Crafts,1173
DIY Electronics,417,485,223989,22350,20044,Technology,902
Dance,1542,780,106193,3572,7833,Dance,2322
Design,1413,2786,755421,17522,40361,Design,4199
Digital Art,371,975,43798,1883,10565,Art,1346
Documentary,5924,10215,1447677,8607,52857,Film & Video,16139
Drama,812,1367,80512,4335,187828,Film & Video,2179
Drinks,594,1828,135486,6133,51350,Food,2422
Electronic Music,700,1470,96342,2573,11106,Music,2170
Embroidery,19,94,1588,840,4452,Crafts,113
Events,158,660,17644,1747,30492,Food,818
Experimental,358,566,26315,2028,61900,Theater,924
Fabrication Tools,66,184,29052,48192,115989,Technology,250
Faith,456,636,48559,4458,13051,Music,1092
Family,66,270,13742,4646,76874,Film & Video,336
Fantasy,106,239,37105,9329,575238,Film & Video,345
Farmer's Markets,70,354,7608,1775,33158,Food,424
Farms,242,912,39480,3938,117271,Food,1154
Fashion,2188,6366,564869,5469,15309,Fashion,8554
Festivals,457,382,33514,3276,26375,Theater,839
Fiction,2233,6936,256892,1441,29885,Publishing,9169
Film & Video,3070,7038,479206,4658,81139,Film & Video,10108
Fine Art,283,493,20969,2430,18792,Photography,776
Flight,76,350,77818,28621,139219,Technology,426
Food,3297,8196,766977,6150,40107,Food,11493
Food Trucks,217,1535,34446,1914,27959,Food,1752
Footwear,298,633,127292,16291,24234,Fashion,931
Gadgets,827,2138,930880,30519,52341,Technology,2965
Games,779,2447,269076,6547,52439,Games,3226
Gaming Hardware,99,329,121584,40088,77286,Games,428
Glass,38,100,2592,1472,8431,Crafts,138
Graphic Design,750,1252,197703,5519,6871,Design,2002
Graphic Novels,1011,853,285759,8216,9885,Comics,1864
Hardware,1206,2457,1136323,43277,93809,Technology,3663
Hip-Hop,602,3310,76388,1180,18975,Music,3912
Horror,397,890,55501,4910,145974,Film & Video,1287
Illustration,1626,1549,205419,3429,28901,Art,3175
Immersive,169,161,14968,4591,151792,Theater,330
Indie Rock,3618,2039,346597,3902,6093,Music,5657
Installations,233,249,23221,4541,150500,Art,482
Interactive Design,79,319,18533,5323,38971,Design,398
Jazz,1104,746,106652,4545,8403,Music,1850
Jewelry,301,938,32893,2649,10694,Fashion,1239
Journalism,472,1275,79379,3044,61988,Journalism,1747
Kids,126,159,16343,4323,13171,Music,285
Knitting,85,96,10990,3737,5993,Crafts,181
Latin,38,99,4368,3016,14086,Music,137
Letterpress,31,18,6078,9665,6276,Crafts,49
Literary Journals,133,145,21355,3489,8870,Publishing,278
Literary Spaces,13,14,2686,7769,21338,Publishing,27
Live Games,180,870,24534,2211,172522,Games,1050
Makerspaces,76,162,13329,5846,130789,Technology,238
Metal,275,442,32208,2292,9386,Music,717
Mixed Media,945,1812,82735,2554,14615,Art,2757
Mobile Games,153,1636,37240,1409,29806,Games,1789
Movie Theaters,52,180,23450,9493,1604097,Film & Video,232
Music,6432,9295,865918,4455,20730,Music,15727
Music Videos,240,469,17623,1925,15712,Film & Video,709
Musical,462,451,42138,4902,54186,Theater,913
Narrative Film,2013,3175,540739,10522,67026,Film & Video,5188
Nature,100,474,9304,1559,26109,Photography,574
Nonfiction,2230,6088,385392,2995,18930,Publishing,8318
Painting,1149,2145,73435,1898,38486,Art,3294
People,230,873,30279,2021,11613,Photography,1103
Performance Art,934,1220,66739,2315,13320,Art,2154
Performances,624,389,40469,3343,11132,Dance,1013
Periodicals,515,750,124508,5667,14395,Publishing,1265
Pet Fashion,37,102,4022,2768,11714,Fashion,139
Photo,32,164,4332,1543,15556,Journalism,196
Photobooks,635,945,119472,7220,12010,Photography,1580
Photography,1876,3876,228125,3597,10636,Photography,5752
Places,118,621,9181,846,9454,Photography,739
Playing Cards,967,1530,388885,6726,10731,Games,2497
Plays,804,574,51377,3131,11323,Theater,1378
Poetry,487,882,33462,1271,5222,Publishing,1369
Pop,1561,1789,179257,3881,11530,Music,3350
Pottery,44,56,4877,3871,7307,Crafts,100
Print,161,566,26683,2309,26257,Journalism,727
Printing,49,189,4421,861,7784,Crafts,238
Product Design,7962,14352,6178913,28546,31335,Design,22314
Public Art,1543,1534,189899,4684,80941,Art,3077
Publishing,1640,4378,346569,3674,46526,Publishing,6018
Punk,146,171,10380,1681,16529,Music,317
Puzzles,88,143,26800,6138,12832,Games,231
Quilts,19,62,1893,2104,11836,Crafts,81
R&B,107,351,11582,1904,12515,Music,458
Radio & Podcasts,394,529,131227,6456,13231,Publishing,923
Ready-to-wear,145,719,26130,3293,39355,Fashion,864
Residencies,50,19,2751,3315,11802,Dance,69
Restaurants,457,2362,102755,4645,109693,Food,2819
Robots,226,346,95266,32612,187211,Technology,572
Rock,3500,3258,333312,3383,8756,Music,6758
Romance,55,135,7316,3520,58345,Film & Video,190
Science Fiction,272,472,67693,8170,405122,Film & Video,744
Sculpture,698,1112,79753,4738,14663,Art,1810
Shorts,6673,5684,453889,3362,20240,Film & Video,12357
Small Batch,557,1251,92287,3936,13528,Food,1808
Software,371,2677,209973,3863,93569,Technology,3048
Sound,274,395,239754,61878,46710,Technology,669
Space Exploration,120,203,99568,30611,576173,Technology,323
Spaces,295,546,59354,7525,99739,Food,841
Stationery,77,142,10225,1715,3782,Crafts,219
Tabletop Games,7866,6314,6049205,32703,14695,Games,14180
Taxidermy,5,8,519,2936,24722,Crafts,13
Technology,1317,5613,1155297,20510,160720,Technology,6930
Television,156,859,75998,8810,442698,Film & Video,1015
Textiles,77,199,7247,2057,33473,Art,276
Theater,4405,2652,342664,3971,12779,Theater,7057
Thrillers,200,546,26698,4283,253826,Film & Video,746
Translations,35,118,5354,2393,253964,Publishing,153
Typography,63,45,30957,21263,15057,Design,108
Vegan,185,403,50252,5755,31379,Food,588
Video,51,377,8476,1622,542843,Journalism,428
Video Art,51,143,4439,2790,25868,Art,194
Video Games,2386,9444,4419505,18279,76740,Games,11830
Wearables,388,845,480791,56284,60564,Technology,1233
Weaving,27,66,3671,5018,19611,Crafts,93
Web,443,4710,222481,2765,85244,Technology,5153
Webcomics,358,290,162720,12651,11636,Comics,648
Webseries,1698,4064,312168,4061,23140,Film & Video,5762
Woodworking,292,875,22612,1599,11597,Crafts,1167
Workshops,50,114,3422,1663,9755,Dance,164
World Music,922,1180,113403,4199,30895,Music,2102
Young Adult,172,649,15927,1256,39869,Publishing,821
Zines,179,212,21725,2595,10451,Publishing,391
